%%%%%%%
%    P%
% %%% %
%  %  %
%%   %%
%.  %%%
%%%%%%%
